"a" = (/turf/open/ground/grass/grass3,/area/space)
"n" = (/turf/open/ground/grass/grass2,/area/space)

(1,1,1) = {"
aaaaaaaaaaaaaaaaaaaaaaaaaaaaaaaaaaaaaaaaaaaaaaaaaaaaaaaaaaaaaaaaaaaaaaaaaaaaaaaaaaaaaaaaaaaaaaaaaaaa
aaaaaaaaaaaaaaaaaaaaaaaaaaaaaaaaaaaaaaaaaaaaaaaaaaaaaaaaaaaaaaaaaaaaaaaaaaaaaaaaaaaaaaaaaaaaaaaaaaaa
aaaaaaaaaaaaaaaaaaaaaaaaaaaaaaaaaaaaaaaaaaaaaaaaaaaaaaaaaaaaaaaaaaaaaaaaaaaaaaaaaaaaaaaaaaaaaaaaaaaa
aaaaaaaaaaaaaaaaaaaaaaaaaaaaaaaaaaaaaaaaaaaaaaaaaaaaaaaaaaaaaaaaaaaaaaaaaaaaaaaaaaaanaaaaaaaaaaaaaaa
aaaaannnaaaaaaaaaaaaaaaaaaaaaaaaaaaaaaaaaaaaaaaaaaaaaaaaaaaaaaaaaaaaaaaaaaaaaaaaaaaaaannaaaaaaaaaaaa
aaaaannnaaaaaaaaaaaaaaaaaaaaaaaaaaaaaaaaaaaaaaaaaaaaaaaaaaaaaaaaaaaaaaaaaaaaaaaaaaaaaannnnnnnnnnnaaa
aaaaannnaaaaaaaaaaaaaaaaaaaaaaaaaaaaaannnaaaaaaaaaaaaaaaaaaaaaaaaaaaaaaaaaaaaaaaanaaaaaannnnnnnnnaaa
aaaaannnaaaaaaaaaaaaaaaaaaaaaaaaaaaaaannnaaaaaaaaaaaaaaaaaaaaaaaaaaaannnnaaaaaaaaaaaaaaannnnnnnnnaaa
aaaaannnaaaaaaaaaaaaaaaaaaaaaaaaaaaaaannnaaaaaaaaaaaaaaaaaaaaaaaaaaaaaaaaaaaaaaaaaaaaaaannnnnnnnnaaa
aaaaaaaaaaaaaaaaanaaaaaaaaaaaaaaaaaaaaaaaaaaaaaaaaaaaaaaaaaaaaaaaaaaaaaaaaaaaaaaaaaaaaaannnnnnnnnaaa
aaaaaaaaaaaaaaaaaaaaaaaaaaanaaaaaaaaaaaaaaaaaaaaaaaaaaaaaaaaaaaaaaaaaaannaaaaaaaaaaaaaaannnnnnnnnaaa
aaaaaaaaaaaaaaaaaaaaaaaaaaaaaaaaaaaaaaaaaaaaaaaaaaaaaaaaaaaaaaaaaaaaaaaaaaaaaaaaaaaaaaaaannaaaaannna
aaaaaaannnaaaaaaaaaaaaaaaaaaaaaaaaaaaaaaaaaaaaaaaaaaaaaaaaaaaaaaaaaaaaaaaaaaaaaaanaaaaaaaaaaaaaaanna
aaaaaaaaaaaaaaaaaaaaaaaaaaaaaaaaaaaaaaaaaaaaaaaaaaaaaaaaaaaaaaaaaaaaaaaaaaaaaaaaanaaaaaaaaannaaaaaan
aaaaaaaaaaaaaaaaaaaaaaaaaaaaaaaaaaaaaaaaaaaaaaaaaaaaaannnaaaaaaaaaaaaaaaaaaaaaaaanaaaaaanaaaannaaaaa
aaaaaaaaaaaaaaaaaaaaaaaaaaaaaaaaaaaaaaaaaaaaaaaaaaaaaannnaaaaaaaaaaaaaaaaaannaaaaaaaaaaaaaaaannaaaaa
aaaaaaaaaaaaaaaaanaaaaaaaaaaaaaaaaaaaaaaaaaaaaaaaaaaaannnaaaaaaaaaaaaaaaaaannaaaaaaaaaaaaaaaaaaaaaaa
aaaaaaaaaaaaaaaaaaaaaaaaannnnnnannnaaaaaaaaaaaaaaaaaaannnaaaaaaaaaaaaaaaaaannaaaaaaaaaaaaaaanaanaaaa
aaaaaaaaaaaaaaaaaaaaaaaaaannnnnnnnnnaanaaaaaaaaaaaaaaaaaaaaaaaaaaaaaaaaaaaannaaaaaaaaaaaaaaanaaaaaaa
aaaaaaaaaaaaaaaaaaaaaaaaaannnnnnnnnnannaaaaaaaaaaaaaaaaaaaaaaaaaaaaaaaaaaaaaaaaaaaaaaaaaaaaaaaaaaaaa
aaaaaaaaaaaaaaaaaaaaaaaaaannnnnnnnnnnnnaaaaaaaaaaaaaaaaaaaaaaaaaaaaaaaaaaaaaaaaaaaaaaaaaaaaaaaaaaaaa
aaaaaaaaaaaaaaaaaaaaaaaaaaaaaanaaaanaaaaaaaaaaaaaaaaaaaaaaaaaaaaaaaaaaaaaaaaaanaaaaaaaaaaaaaaaaaaaaa
aaaaaaaaaanaaaaaaaaaaaaaaaaaaaannaaaaaaaaaaaaaanaaaaaaaaaaaaaaaaaaaaaaaaaaaaaanaaaaaaaaaaaaaaaaaaaaa
aaaaaaaaaaaaaaaaaaaaaaaaanaaaaanaaaaaaaaaaaaaaanaaaaaaaaaaaaaaannaaaaaaaaaaaaaaaaaaaaaaaaaaaaaaaaaaa
aaaaaaaaaaaaaaaaaaaaaaaaanaaaaaaaaaaaaaaaaaaaaaaaaaaaaaaaaaaaaaaaaaaaaaaaaaaaaaaaaaaaannaaaaaaaanaaa
aaaaaaaaaaaaaannnaaaaaaaaaaaaaaaaaaanaaaaaaaaaaaaaaaaaaaaaaaaaaaaaaaaaaaaaaaaaaaaaaaaannaaaaaaaanaaa
aaaaaaaaaaaannnnnaaaaaaaaaaaaaaaaaaaaaaaaaaaaaaaaaaaaaaaaaaannaaaaaaaaaaaaaaaaaaaaaaaannaaaaaaaaaaaa
aaaaaaaaaaaannnnnnaaaaaaaaaaaaaaaaaaaaaaanaaaaaaaaaaaaaaaaannnnnnnnaaaaaaaaaaaaaaaaaaannaaaaaaaaaaaa
aaaaaaaaaaaannnnnnaaaaaaaaaaaaaaaaaaannnaaaaaaaaaaaaaaaaaaaannnnaaaaaaaaaaaaaaaaaaaaaaaaaaaaaaaaaaaa
aaaaaaaaaaannnnnnaaaaaaaaaaaaaaaaaaaannnaaaaaaaaaaaaaaanaaaannaaaaaanaaaaaaaaaaaaaaaaaaanaaaaaaaaaaa
aaaaaaaaaaannnnnnaaaaaaaaaaaaaaaaaaaannnaaaaaaaaaaaaaaaaaaaannaaaaaaaaaaaaaaaaaaaaaaaaaanaaaaaaaaaaa
aaaaaaaaaaaannnnnaaaaaaaaaaaaaaaaaaaaaaaannnaaaaaaaaaaaaaaaannaaaaaaaaaaaaaaaaaaaaaaaaaanaaaaaaaaaaa
aaaaaaaaaaaannnnnnnaaaaaaaaaaaaaaaaaaaaaaaaaaaaaaaaaaaaaaaaaaaaaaaaaaaaaaaaaaaaaaaaaaaaaaaaaaaaaaaaa
aaaaaaaaaaaannnnnaaaaaaaaaaaaaaaaaaaaaaaaaaaaaaaaaaaaaaaaaaaaaaaaaaaaaaaaaaaaaaaaaaaaaaaaaaaaaanaaaa
aaaaaaaaaaaannnnnaaaaaaaaaaaaaaaaaaaaaaaaaaaaaaaaaaaaaaaaaaaaaaaaaaaaaaaaaaaaaaaaaaaaaanaaaaaaaaaaaa
aaaaaaaaaaaaaaaaaaaaaaaaaaaaaaaaaaaaaaaaaaaaaaaaaaaaaaaaaaaaaaaaaaaaaaaaaaaaaaaaaaaaaaaaaaaaaaaaaaaa
aaaaaaaaaaaaaaaaaaaaaaaaaaaaaaaaaaaaaaaaaaaaaanaaaaanaaaaaaaaaaaaaaaaaaaaaaaaaaaaaaaaaaaaaaaaaaaaaaa
aaaaaaaaaaaaaaaaaaaaaaaanaaaaaaanaaaaaaaaaaaaaaaaaaaaaaaaaaaaaaaaaaaaaaaaaaaaaaaannaaaaaaaaaaaaaaaaa
aaaaaaaaaaaaaaaaaaaaaaaaaaaaaaaaaaaaaaanaaaaaaaaaaaaaaaaaaaaaaaaannaaaaaaaaaaaaaannaaaaaaaaaaaaaaaaa
aaaaaaaaaaaaaaanaaaaaaaaaaaaaaaaaaaaaaanaaaaaaaaaaanaaaaaaaaaaaaaaaaaaaaaaaaaaaaaaaaaaaaaaaaaaaaaaaa
aaaaaaaaaaaaaaaaaaaaaaaaaaaaanaaaaanaaaaaaaaannaaaanaaaaaaaaaaaaaaaaaanannnnaaaaaaaaaaaaaaaaaanaaaaa
aaaaaaaaaaaaaaaaaaaaaaaanaaaaaaaaaaaaaaaaaaaannaaaanaaaaaaaaaaaaaaaaaaaannnnaaaaaaaaaaaaaaaaaanaaaaa
aaaaaaaaaaaaaaaaaaaaaaaaaaaaaaaaaaaaaaaaaaaaannaaaanaaaaaaaaaaaaaaaaaaannnnnaaaaaaaaaaaaaaaaaaaaaaaa
aaaaaaaaaaaaaaaaaaaaaaaaaaaaaaaaaaaaaaaaaaaaannaaaanaaaaaaaaaaaaaaaaaaannnnnnnaaaaaaaaaaaaaaaaaaaaaa
aaaaaaaaaaaaaaaaaaaaaaaaaaaaaanaaaaaaaaaaaaaaaanaaaaaaaaaaaaaaaaaaaaaaaannnnaaanaaaaaaaaaaaaaaaaaaaa
aaaaaaaaaaaaaaaaaaaaaaaaaaaaaaaaaaaaaaaaaaaaaaaaaaaaaaaaaaaaaaaaaaaaaaaaaanaaaaanaaaaaaaaaaaaanaaaaa
aaaaaaaaaaaaaaaaaaaaaaaaaaaaaaaaaaaaaaaaaaaaaaaaaaaaaaaaaaaaaaaaaaaaaaaaaanaaaaaaaaaaaaaaanaaanaaaaa
aaaaaaaaaaaaaaaaaaaaaaaaaaaaaaaaaaaaaaaaaaaaaaaaaaaaaaaaaaaaaaaaaaaaaaaaaaaaaaaaaaaaaaaaaaaaaaaaaaaa
aaaaaaaaaaaaaaaaaanaaaaaaaaaaaaaaaaaaaaanaaaaaaaaaaaaaaaaaaaaaaaaaaaaaaaaaanaaaaaaaaaaaaaaaaaaaaaaaa
aaaaaaaaaaaaaaaaaanaaaaaaaaaaaaaaaaaaaaaaaaaaaaaaaaaaaaaaaaaaaaaaaaaaaaaaaaaaaaaaaaaannaaaaaaaaaaaaa
aaaaaaaaaaaaaaaaaaaaaaaaaaaaaaaaaaaaaaaaaaaaaaaaaaaaaaaaaaaaaaaaaaaaanaaaaaaaaaaaaaaannaaaaaaaaaaaaa
aaaaaaaaaaaaaaaaaaaaaaaaaaaaaaaaaaaanaaaaaaaaaaaaaaaaaaaannnaaaaaaaaanaaaaaaaaaaaaaaaaaaaaaaaaannaaa
aaaaaaaaaaaaaaaaaaaaaaaaaaaanaaanannaaaaaaaaaaaaaaaaaaaaannnaannaaaaanannaaaaaaaaaaaaaaaaaaaaaaaaaaa
aaaaaaaaaaaaaaaanaaaaaaaaaaaaaaaaannaaaaaaaaaaaaaaaaaaaaaaaaaannaaaaanannaaaaaaaaaaaaaaaaaaaanaaaaaa
aaaaaaaaaaaaaaaanaaaaaaaaaaaaaaaaaaaaaaaaaaaaaaaaaaaaaaaaaaaaaaaaaaaanannaaaaaaaaaaaaaaaaaaaaaaaaaaa
aaaaaaaaaaaaaaaaaaaaaaaaaaaaaaaaaaaaaaaaaanaaaaannnaaaaaaaaaaaaaaaaaaaannnaaaaaaaaaaaaaaaaaaaaaaaaaa
aaaaaaaaaaaaaaaaaaaaaaaaaaaaaaaaaaaaaaaaaaaaaaaannnaaaaaaaaaaaaaaaaaaaannnnaaaaaaaaaaaaaaaaaaaaaaaaa
aaaaaaaaaaaaaaaaaaaaaaaaaaaaaaaaaaaaaaaaaaaaaaaannnaaaaaaanaaaaaaaaaaaannaaaaaaaaaaaaaaaaaaaaaaaaaaa
aaaaaaaaaaaaaaaaaaaaaaaaaaaaaaaaaaaaanaaaaaaaaaaaaaaaaaaannaaaaaaaaaaaannaanaaaaaaaaaaaaaaaanaaaaaaa
aaaaaaaaaaaaaaaaaaaaaaaaaaaaaannnnnnnaaaaaaaaaaaaaaaaaaaannaaaaaaaaaaaannaaaaaaaaaaaaaaaaaaanaaaaaaa
aaaaaaaaaaaaaaaaaaaaaaaaaaaaaannnnnnnaaaaaaaaaaaaaaaaaaaaaaaaaaaaaaaaaaaaaaaaaannnnnaaaaaaaaaaaaaaaa
aaaaaaaaaaaaaaaaaaaaaaaaaaaaaannnnnnnnaaaaaaaaaaaaaaaaaaaaaaaaaaaaaaaaaaaaaaaaaaaanaaaaaaaaaaaaaaaaa
aaaaaaaaaaaaaaaaaaaaaaaaaaaannnnnnnnnnaaaaaaaaaaaaaaaaaaaaaaaanaaaaaaaaaaaaaaaaaaanaaaaaaaaaaaaaaaaa
aaaaaaaaaaaaaaaaaaaaaaaaaaaaaaaaaaaaaaaaaaaaaaaaaaaaaaaaaaaaaanaaaaaaaaaaaaaaaaaaanaaaaaaaaaaaaaaaaa
aaaaaaaaaaaaaaaaaaaanaaaaaaaaaaaaaaaaaaaaaaaaaaaaaaaaaaaaaaaaaaaaaaaaaaaaaaaaaaannaaaaaaaaaaaaaaaaaa
aaaaaaaaaaaaaaaaaaaanaaaaaaaaaaaaaaaaaaaaaaaaaaaaaaaaaaaaaaaaaaaaaaaaaaaaaaaaaaaaaaaaaaaaaaaaaaaaaaa
aaaaaaaaaaaaaaaaaaaaaaaaaaaaaaaaaaaaaaaaaaaaaaaaaaaaaaaaaaaaaaaaaaaaaaaaaaaaaaaaaaaaaaaaaaaaaaaaaaaa
aaaaaaaaaaaaaaaaaaaaaaaaaaaaaaaaaaaaaaaaaaaaaaaaaaaaaaaaaaaaaaaaaaaaaaaaaaaaaaaaaaaaaaaaaaaaaaaaaaaa
aaaaaaaaaaaaaaaaaaaaaaaaaaaaaaaaaaaaaaaaaaaaaaaaaaaaaaaaaaaaaaaaaaaaaaaaaaaaaaaaaaaaaaaaaaaaaaaaaaaa
aaaaaaaaaaaaaaaaaaaaaaaaaaaaaaaaaaaaaaaaaaaaaaaaaaaaaaaaaaaaaaaaaaaaaaaaaaaaaaaaaaaaaaaaaaaaaaaaaaaa
aaaaaaaaaaaaaaaaaaaaaaaaaaaaaaaaaaaaaaaaaaaaanannaaaaaaaaaaaaaaaaaaaaaaaaaaaaaaaaaaaaaaaaaaaaaaaaaaa
aaaaaaaaaaaaaaaaaaaaaaaaaaaaaaaaaaaaaaaaaaaaanaaaaaaaaaaaannnaaaaaaaaaaaaaaaaaaaaaaaaaaaaaaaaaaaaaaa
aaaaaaaaaaaaaaaaaaaaaaaaaaaaaaaaaaaaaaaaaaaaanaaaaaaaaaaanannaaaaaaaaaaaaaaaaaaaaaaaaaaaaaaaaaaaaaaa
aaaaaaaaaaaaaaaaaaaaaaaaaanaaaaaaaaaaaaaaaaaaaaaaaaaaaaannnnnnnaaaaaannnaaaaaaaaaaaaaaaaaaaaaaaaaaaa
aaaaaaaaaaaaaaaaaaaaaaaaaaaaaaaaaaaaaaaaaaaaaaaaaaaaaaaannnnnaaaaaaaaaaaaaaaaaaaaaaaaaaaaaanaaaaaaaa
aaaaaaaaaaaaaaaaaaaaaaaaaaaaaaaaaaaaaaaaaaaaaaaanaaaaaaanaaaaanaaaaaaaaaaaaaaaaaaaaaaaaaaaaaaaaaaaaa
aaaaaaaaaaaaaaaaaaaaaaaaaaaaaaaaaaaaaaaaaaaaaaaanaaaaaaaaaaaaaaaaaaaaaaaaaaaaaaaaaaaaaaaaaaaaaaaaaaa
aaaaaaaaaaaaaaaaaaaaaaaaaaaaaaaaaaaaaaaaaaaaaaaaaaanaanaaaaaaaaaaaaaaaaaaaaaaaaaaaanaaaaaaaaaaaaaaaa
aaaaaaaaaaannaaaaaaaaaaaaaaaaaaaaaaaaaanaaaaaaaaaaaaaaaaaaaaaaaaaaaaaaaaaaaaaaaaaaaaaaaaaaaaaaaaaaaa
aaaaaaaaaaaaaaaaaaaaaaaaaaaaaaaaaaaaaaaaaaaaaaaaaaaaaaaaaaaaaaaaaaaaaaaaaaaanaaaaaaaaaaaaaaaaaaaaaaa
aaaaaaaaaaaaaaannaaaaaaaaaaaaaaaaaaaaaaaaaaaaaaaaaaaaaaaaaaaaanaaaaaaaaaaaaaaaaaaaaaaaaaaaaaaaaaaaaa
aaaaaaaaaaaaaaaaaaaaaaaaaaaaaaaaaaaaaaaaaaaaaaaaaaaaaaaaaaaaaaaaaaaaaaaaaaaaaaaaaaaaaaaaaaaaaaaaaaaa
aaaaaaaaaaaaaaaaaaaaaaaaaaaaaaaaaaaaaaaaaaaaaaaaaaaaaaaaaaaaaaaaaaaaaaaaaaaaaaaaaaaaaaaaaaaaaaaaaaaa
aaaaaaaaaaaaaaaaaaaaaaaaaaaaaaaannaaaaaaaaaanaaaaaaaaaaaaaaaaaaaaaaaaaaaaaaaaaaaaaaaanaaaaaaaaaaaaaa
aaaaaaaaaaaaaaaaaaaaaaannnaaaaaannaaaaaaaaaaaaaaaaaaaaaaaaaaaaaaaaaaaaaaaaaaaaaaaaaaanannanaaaaaaaaa
aaaaaaaaaaaaaaaaaaaaaaaaaaaaaaaaaaaaaaaaaaaaaaaaaaaaaaaaaaaaaaaaaaaaaaaaaaaaaaaaaaaaaannnanaaaaaaaaa
aaaaaaaaaaaaaaaaaaaaaaaaaaaaaaaaaaaaaaaaaaaaaaaaaaaaaaaaaaaaaaaaaaaaaaaaaaaannnnaaaaaannnnaaaaaaaaaa
aaaaaaaaaaaaaaaaaaaaaaaaaaaaaaaaaaaaaaaaaaaaaaaaaaaaaaaaaaaaaaaaaaaaaaaaaaaaaannaaaaaaannnaaaaaaaaaa
aaaaaaaaaaaaaaaaaaaaaaaaaaaaaaaaaaaaaaaaaaaaaaaaaaaaaaaaaaaaaaaaaaaaaaaaaaaaaaannaaaaaannaaaaaaaaaaa
aaaaaaaaaaaaaaaaaaaaaaaaaaaaaaaaaaaaaaaaaaaaaaaaaaaaaaaaaaaaaaaaaaaaaaaaaaaaannnnnnnaaaaaaaaaaaaaaaa
aaaaaaaaaaaaaaaaaaaaaaaaaaaaaaaaaaaaaaaaaaaaaaaaaaaaaaaaaaaaaaaaaaaaaaaaaaaaannnnnnnaaaaaaaaaaaaaaaa
aaaaaaaaaaaaaaaaaaaaaaaaaaaaaaaaaaaaaaaaaaaaaaaaaaaaaaaaaaaaaaaaaaaaaaaaaaaaannnnnnnaaaaaaaaaaaaaaaa
aaaaaaaaaaaaaaaaaaaaaaaaaaaaaaaaaaaaaaaaaaaaaaaaaaaaaaaaaaaaaaaaaaaaaaaaaaaaannnnnnnannnaaaaaaaaaaaa
aaaaaaaaaaaaaaaaaaaaaaaaaaaaaaaaaaaaaaaaaaaaaaaaaaaaaaaaaaaaaaaaaaaaaaaaaaaaaaaaaaaaaaanaaaaaaaaaaaa
aaaaaaaaaaaaaaaaaaaaaaaaaaaaaaaaaaaaaaaaaaaaaaaaaaaaaaaaaaaaaaaaaaaaaaaaaaaaaaaaaaaaaaaaaaaaaaaaaaaa
aaaaaaaaaaaaaaaaaaaaaaaaaaaaaaaaaaaaaaaaaaaaaaaaaaaaaaaaaaaaaaaaaaaaaaaaaaaaaaaaaaaaaaaaaaaaaaaaaaaa
aaaaaaaaaaaaaaaaaaaaaaaaaaaaaaaaaaaaaaaaaaaaaaaaaaaaaaaaaaaaaaaaaaaaaaaaaaaaaaaaaaaaaaaaaaaaaaaaaaaa
aaaaaaaaaaaaaaaaaaaaaaaaaaaaaaaaaaaaaaaaaaaaaaaaaaaaaaaaaaaaaaaaaaaaaaaaaaaaaaaaaaaaaaaaaaaaaaaaaaaa
aaaaaaaaaaaaaaaaaaaaaaaaaaaaaaaaaaaaaaaaaaaaaaaaaaaaaaaaaaaaaaaaaaaaaaaaaaaaaaaaaaaaaaaaaaaaaaaaaaaa
aaaaaaaaaaaaaaaaaaaaaaaaaaaaaaaaaaaaaaaaaaaaaaaaaaaaaaaaaaaaaaaaaaaaaaaaaaaaaaaaaaaaaaaaaaaaaaaaaaaa
"}
