//MAP CONVERTED BY dmm2tgm.py THIS HEADER COMMENT PREVENTS RECONVERSION, DO NOT REMOVE
"a" = (
/turf/open/floor/grass,
/area/assembly/assembly_line)
"b" = (
/obj/effect/landmark/start/job/chiefshipengineer/rebel,
/turf/open/floor/grass,
/area/assembly/assembly_line)
"c" = (
/obj/effect/landmark/start/job/synthetic/rebel,
/turf/open/floor/grass,
/area/assembly/assembly_line)
"d" = (
/obj/effect/particle_effect/fire,
/obj/flamer_fire,
/turf/open/floor/grass,
/area/assembly/assembly_line)
"e" = (
/obj/structure/bed/chair{
	dir = 8
	},
/obj/effect/landmark/start/job/squadmarine/rebel,
/turf/open/floor/grass,
/area/assembly/assembly_line)
"g" = (
/obj/structure/table,
/obj/effect/spawner/random/drink_alcohol_bottle,
/turf/open/floor/grass,
/area/assembly/assembly_line)
"h" = (
/mob/living/simple_animal/hostile/mimic/crate,
/turf/open/floor/grass,
/area/assembly/assembly_line)
"i" = (
/obj/item/bedsheet,
/obj/structure/bed,
/turf/open/floor/grass,
/area/assembly/assembly_line)
"j" = (
/obj/structure/table/woodentable,
/obj/item/tool/kitchen/utensil/spoon,
/turf/open/floor/grass,
/area/assembly/assembly_line)
"k" = (
/obj/effect/landmark/start/job/squadsmartgunner/rebel,
/turf/open/floor/grass,
/area/assembly/assembly_line)
"l" = (
/obj/structure/bed/chair{
	dir = 4
	},
/turf/open/floor/grass,
/area/assembly/assembly_line)
"m" = (
/obj/structure/prop/mainship/minigun_crate,
/obj/structure/largecrate/supply/weapons/standard_smg,
/turf/open/floor/grass,
/area/assembly/assembly_line)
"n" = (
/obj/structure/bed/chair{
	dir = 4
	},
/obj/effect/landmark/start/job/squadmarine/rebel,
/turf/open/floor/grass,
/area/assembly/assembly_line)
"o" = (
/obj/machinery/robotic_fabricator,
/turf/open/floor/grass,
/area/assembly/assembly_line)
"p" = (
/obj/structure/closet,
/obj/effect/spawner/random/sugary_snack,
/obj/item/weapon/combat_knife,
/turf/open/floor/grass,
/area/assembly/assembly_line)
"q" = (
/obj/effect/landmark/start/job/squadcorpsman/rebel,
/turf/open/floor/grass,
/area/assembly/assembly_line)
"r" = (
/obj/structure/connectable/tent_wall,
/turf/open/floor/grass,
/area/assembly/assembly_line)
"s" = (
/obj/effect/decal/remains/robot,
/obj/effect/landmark/start/job/researcher/rebel,
/turf/open/floor/grass,
/area/assembly/assembly_line)
"t" = (
/obj/structure/closet/crate/ammo,
/turf/open/floor/grass,
/area/assembly/assembly_line)
"u" = (
/obj/structure/bed/chair{
	dir = 1
	},
/turf/open/floor/grass,
/area/assembly/assembly_line)
"v" = (
/obj/structure/bed/chair{
	dir = 1
	},
/obj/effect/landmark/start/job/captain/rebel,
/turf/open/floor/grass,
/area/assembly/assembly_line)
"w" = (
/obj/structure/bed/chair{
	dir = 1
	},
/obj/effect/landmark/start/job/survivor,
/turf/open/floor/grass,
/area/assembly/assembly_line)
"x" = (
/obj/structure/connectable/tent_wall,
/obj/structure/connectable/tent_wall,
/turf/open/floor/grass,
/area/assembly/assembly_line)
"y" = (
/obj/structure/largecrate/supply/supplies/water,
/turf/open/floor/grass,
/area/assembly/assembly_line)
"z" = (
/obj/structure/connectable/tent_wall,
/turf/open/space/basic,
/area/assembly/assembly_line)
"A" = (
/obj/machinery/door/tent,
/turf/open/floor/grass,
/area/assembly/assembly_line)
"B" = (
/obj/structure/closet,
/obj/effect/spawner/random/outdoors_snacks,
/obj/item/weapon/combat_knife,
/turf/open/floor/grass,
/area/assembly/assembly_line)
"C" = (
/obj/machinery/roomba,
/turf/open/floor/grass,
/area/assembly/assembly_line)
"D" = (
/obj/structure/largecrate/supply/weapons/flamers,
/turf/open/floor/grass,
/area/assembly/assembly_line)
"E" = (
/obj/structure/largecrate/supply/weapons/hpr,
/turf/open/floor/grass,
/area/assembly/assembly_line)
"F" = (
/turf/closed/wall/wood,
/area/assembly/assembly_line)
"G" = (
/obj/effect/landmark/start/job/fieldcommander/rebel,
/turf/open/floor/grass,
/area/assembly/assembly_line)
"H" = (
/obj/structure/closet/crate/freezer,
/turf/open/floor/grass,
/area/assembly/assembly_line)
"I" = (
/obj/effect/landmark/start/job/squadmarine/rebel,
/turf/open/floor/grass,
/area/assembly/assembly_line)
"J" = (
/obj/effect/decal/remains/robot,
/turf/open/floor/grass,
/area/assembly/assembly_line)
"K" = (
/obj/effect/landmark/start/job/requisitionsofficer/rebel,
/turf/open/floor/grass,
/area/assembly/assembly_line)
"L" = (
/obj/structure/largecrate/supply/supplies/metal,
/turf/open/floor/grass,
/area/assembly/assembly_line)
"M" = (
/turf/open/beach/sand,
/area/assembly/assembly_line)
"N" = (
/obj/item/bedsheet,
/obj/structure/bed,
/obj/effect/landmark/start/job/squadmarine/rebel,
/turf/open/floor/grass,
/area/assembly/assembly_line)
"O" = (
/obj/structure/largecrate/supply/supplies/mre,
/turf/open/floor/grass,
/area/assembly/assembly_line)
"P" = (
/obj/machinery/vending/robotics,
/turf/open/floor/grass,
/area/assembly/assembly_line)
"Q" = (
/obj/machinery/autolathe,
/turf/open/floor/grass,
/area/assembly/assembly_line)
"R" = (
/obj/structure/table/woodentable,
/obj/item/tool/kitchen/utensil/fork,
/turf/open/floor/grass,
/area/assembly/assembly_line)
"S" = (
/obj/structure/table/woodentable,
/obj/item/tool/kitchen/utensil/fork,
/obj/item/tool/kitchen/utensil/spoon,
/turf/open/floor/grass,
/area/assembly/assembly_line)
"T" = (
/obj/effect/decal/remains/robot,
/obj/effect/landmark/start/job/shiptech/rebel,
/turf/open/floor/grass,
/area/assembly/assembly_line)
"U" = (
/obj/item/book/manual/robotics_cyborgs,
/turf/open/floor/grass,
/area/assembly/assembly_line)
"V" = (
/obj/structure/largecrate/supply/generator,
/turf/open/floor/grass,
/area/assembly/assembly_line)
"W" = (
/obj/structure/largecrate/supply/weapons/shotgun,
/turf/open/floor/grass,
/area/assembly/assembly_line)
"X" = (
/obj/item/bedsheet,
/obj/structure/bed,
/obj/effect/landmark/start/job/squadmarine/rebel,
/obj/effect/landmark/start/latejoinrebel,
/turf/open/floor/grass,
/area/assembly/assembly_line)
"Y" = (
/obj/item/bedsheet,
/obj/structure/bed,
/obj/effect/landmark/start/latejoin_cryo,
/turf/open/floor/grass,
/area/assembly/assembly_line)
"Z" = (
/obj/machinery/r_n_d/protolathe,
/turf/open/floor/grass,
/area/assembly/assembly_line)

(1,1,1) = {"
a
a
a
a
a
a
a
a
a
a
a
a
a
a
a
a
a
a
a
a
a
a
a
a
a
a
a
a
a
a
a
a
a
a
a
a
a
a
a
a
a
a
a
a
a
a
a
a
a
a
"}
(2,1,1) = {"
a
a
a
a
a
a
a
a
a
a
a
a
a
a
a
a
a
a
a
a
a
a
a
a
a
a
a
a
a
a
a
a
a
a
a
a
a
a
a
a
a
a
a
a
a
a
a
a
a
a
"}
(3,1,1) = {"
a
a
a
a
a
a
a
a
a
a
a
a
a
a
a
a
a
a
a
a
a
a
a
a
a
a
a
a
a
a
a
a
a
a
a
a
a
a
a
a
a
a
a
a
a
a
a
a
a
a
"}
(4,1,1) = {"
a
a
a
a
a
a
a
a
a
a
a
a
a
a
a
a
a
a
a
a
a
a
a
a
a
a
a
a
a
a
a
a
a
a
a
a
a
a
a
a
a
a
a
a
a
a
a
a
a
a
"}
(5,1,1) = {"
a
a
a
a
a
a
a
a
a
a
a
a
a
a
a
a
a
a
a
a
a
a
a
a
a
a
a
a
a
a
a
a
a
a
a
a
a
a
a
a
a
a
a
a
a
a
a
a
a
a
"}
(6,1,1) = {"
a
a
a
a
a
a
a
a
a
a
a
a
a
a
a
a
a
a
a
a
a
a
a
a
a
a
a
a
a
a
a
a
a
a
a
a
a
a
a
a
a
a
a
a
a
a
a
a
a
a
"}
(7,1,1) = {"
a
a
a
a
a
a
F
F
F
F
F
F
F
F
F
F
F
F
F
F
F
F
F
F
F
F
F
F
F
F
F
F
F
F
F
F
F
F
F
F
F
F
F
F
a
a
a
a
a
a
"}
(8,1,1) = {"
a
a
a
a
a
a
F
a
a
r
r
r
r
r
a
a
r
r
r
r
r
a
a
a
a
a
a
a
a
a
a
a
a
a
a
a
a
a
a
a
a
a
a
F
a
a
a
a
a
a
"}
(9,1,1) = {"
a
a
a
a
a
a
F
a
a
r
p
a
B
r
a
a
r
p
g
B
r
a
a
a
a
a
a
a
a
a
a
a
a
a
a
a
a
a
a
a
a
a
a
F
a
a
a
a
a
a
"}
(10,1,1) = {"
a
a
a
a
a
a
F
a
a
r
I
l
I
A
a
a
r
a
e
a
z
a
a
a
a
a
a
a
a
a
a
a
a
a
a
a
a
a
a
a
a
a
a
F
a
a
a
a
a
a
"}
(11,1,1) = {"
a
a
a
a
a
a
F
a
a
r
i
g
i
r
a
a
r
i
a
N
r
a
a
a
a
a
a
a
a
a
a
a
a
a
a
a
a
a
a
a
a
a
a
F
a
a
a
a
a
a
"}
(12,1,1) = {"
a
a
a
a
a
a
F
a
a
r
r
r
r
r
a
a
r
r
A
r
r
a
a
a
a
a
a
a
a
a
a
r
r
r
r
r
r
r
r
r
x
a
a
F
a
a
a
a
a
a
"}
(13,1,1) = {"
a
a
a
a
a
a
F
a
a
a
a
a
a
a
a
a
a
a
a
a
a
a
a
a
a
a
a
a
a
a
a
r
S
u
a
H
H
a
u
S
r
a
a
F
a
a
a
a
a
a
"}
(14,1,1) = {"
a
a
a
a
a
a
F
a
a
a
a
a
a
a
a
a
a
a
a
a
r
r
r
r
r
a
a
a
a
a
a
r
S
w
a
a
a
a
w
S
r
a
a
F
a
a
a
a
a
a
"}
(15,1,1) = {"
a
a
a
a
a
a
F
r
r
r
r
r
a
r
r
A
r
r
a
a
r
p
a
B
r
a
a
a
a
a
a
r
S
u
M
M
M
M
u
S
r
a
a
F
a
a
a
a
a
a
"}
(16,1,1) = {"
a
a
a
a
a
a
F
r
p
a
B
r
a
r
N
a
i
r
a
a
A
a
l
a
z
a
a
a
a
a
a
r
j
w
M
d
d
M
v
R
r
a
a
F
a
a
a
a
a
a
"}
(17,1,1) = {"
a
a
a
a
a
a
F
r
a
n
I
A
a
r
a
n
a
z
a
a
r
N
g
N
r
a
a
a
a
a
a
r
S
w
M
M
M
M
u
R
r
a
a
F
a
a
a
a
a
a
"}
(18,1,1) = {"
a
a
a
a
a
a
F
r
i
g
i
r
a
r
B
g
p
r
a
a
r
r
r
r
r
a
a
a
a
a
a
r
j
u
a
a
a
a
u
S
r
a
a
F
a
a
a
a
a
a
"}
(19,1,1) = {"
a
a
a
a
a
a
F
r
r
r
r
r
a
r
r
r
r
r
a
a
a
a
a
a
a
a
a
a
a
a
a
r
S
w
a
a
a
a
w
R
r
a
a
F
a
a
a
a
a
a
"}
(20,1,1) = {"
a
a
a
a
a
a
F
a
a
a
a
a
a
a
a
a
a
a
a
a
a
a
a
r
r
r
r
r
a
a
a
r
S
u
a
a
a
a
w
S
r
a
a
F
a
a
a
a
a
a
"}
(21,1,1) = {"
a
a
a
a
a
a
F
a
a
a
a
a
a
a
a
a
a
a
a
a
a
a
a
r
p
a
B
r
a
a
a
x
r
r
r
A
A
r
r
r
x
a
a
F
a
a
a
a
a
a
"}
(22,1,1) = {"
a
a
a
a
a
a
F
a
a
a
a
r
r
A
r
r
a
r
r
r
r
r
a
A
a
l
a
z
a
a
a
a
a
a
a
a
a
a
a
a
a
a
a
F
a
a
a
a
a
a
"}
(23,1,1) = {"
a
a
a
a
a
a
F
a
a
a
a
r
p
a
B
r
a
r
p
a
N
r
a
r
N
g
N
r
a
a
a
a
a
a
a
a
a
a
a
a
a
a
a
a
a
a
a
a
a
a
"}
(24,1,1) = {"
a
a
a
a
a
a
F
a
a
a
a
r
a
l
a
z
a
A
a
u
g
r
a
r
r
r
r
r
a
a
a
a
a
a
a
a
a
k
a
a
a
a
a
a
a
a
a
a
a
a
"}
(25,1,1) = {"
a
a
a
a
a
a
F
a
a
a
a
r
X
g
N
r
a
r
B
a
N
r
a
a
a
a
a
a
a
a
a
a
a
a
a
a
a
q
a
G
a
a
a
a
a
a
a
a
a
a
"}
(26,1,1) = {"
a
a
a
a
a
a
F
a
a
a
a
r
r
r
r
r
a
r
r
r
r
r
a
a
a
a
a
a
a
a
a
a
a
a
a
a
a
k
a
a
a
a
a
a
a
a
a
a
a
a
"}
(27,1,1) = {"
a
a
a
a
a
a
F
r
r
r
r
r
a
a
a
a
a
a
a
a
a
a
a
a
a
a
a
a
a
a
a
a
a
a
a
a
a
a
a
a
a
a
a
a
a
a
a
a
a
a
"}
(28,1,1) = {"
a
a
a
a
a
a
F
r
p
a
B
r
a
a
a
a
a
r
r
r
r
r
a
a
a
a
a
a
a
a
a
a
a
a
a
a
a
a
a
a
a
a
a
a
a
a
a
a
a
a
"}
(29,1,1) = {"
a
a
a
a
a
a
F
r
I
l
I
A
a
a
a
a
a
r
p
g
B
r
a
a
a
a
a
a
a
a
a
a
a
a
a
a
a
a
a
a
a
a
a
F
a
a
a
a
a
a
"}
(30,1,1) = {"
a
a
a
a
a
a
F
r
i
g
i
r
a
a
a
a
a
r
a
e
a
z
a
a
a
a
a
a
a
a
a
a
a
a
a
a
a
a
a
a
a
a
a
F
a
a
a
a
a
a
"}
(31,1,1) = {"
a
a
a
a
a
a
F
r
r
r
r
r
a
a
a
a
a
r
Y
a
N
r
a
a
a
a
a
a
a
a
a
a
a
a
a
a
a
a
a
a
a
a
a
F
a
a
a
a
a
a
"}
(32,1,1) = {"
a
a
a
a
a
a
F
a
a
a
a
a
a
a
a
a
a
r
r
A
r
r
a
a
a
a
a
a
a
a
a
a
a
a
a
a
a
a
a
a
a
a
a
F
a
a
a
a
a
a
"}
(33,1,1) = {"
a
a
a
a
a
a
F
a
r
r
r
r
r
a
a
a
a
a
a
a
a
a
a
a
a
a
a
a
a
a
a
a
a
a
a
F
A
r
r
r
r
r
r
F
a
a
a
a
a
a
"}
(34,1,1) = {"
a
a
a
a
a
a
F
a
r
p
a
B
r
a
r
r
A
r
r
a
a
a
a
a
a
a
a
a
a
a
a
a
a
a
a
A
a
a
a
a
a
a
D
F
a
a
a
a
a
a
"}
(35,1,1) = {"
a
a
a
a
a
a
F
a
r
a
n
I
A
a
r
N
a
i
r
a
a
a
a
a
a
a
a
a
a
a
a
a
a
a
a
r
a
K
a
a
L
a
E
F
a
a
a
a
a
a
"}
(36,1,1) = {"
a
a
a
a
a
a
F
a
r
i
g
i
r
a
r
a
n
a
z
a
a
a
a
a
a
r
r
r
a
a
r
r
r
a
a
r
O
a
a
a
L
a
W
F
a
a
a
a
a
a
"}
(37,1,1) = {"
a
a
a
a
a
a
F
a
r
r
r
r
r
a
r
B
g
p
r
a
a
a
a
a
a
r
F
a
a
a
a
F
r
a
a
r
O
a
a
a
L
a
W
F
a
a
a
a
a
a
"}
(38,1,1) = {"
a
a
a
a
a
a
F
a
a
a
a
a
a
a
r
r
r
r
r
a
a
a
a
a
a
r
C
J
a
J
a
P
r
a
a
r
O
a
a
a
a
a
W
F
a
a
a
a
a
a
"}
(39,1,1) = {"
a
a
a
a
a
a
F
a
a
a
a
a
a
a
a
a
a
a
a
a
a
a
a
a
a
r
o
U
a
b
a
a
r
a
a
r
y
a
a
a
a
a
W
F
a
a
a
a
a
a
"}
(40,1,1) = {"
a
a
a
a
a
a
F
a
a
a
a
a
a
a
a
a
a
a
a
a
a
a
a
a
a
r
a
a
a
c
a
T
r
a
a
r
y
a
a
a
V
a
W
F
a
a
a
a
a
a
"}
(41,1,1) = {"
a
a
a
a
a
a
F
a
a
a
a
a
a
a
a
a
a
a
a
a
a
a
a
a
a
r
J
a
a
s
a
a
r
a
a
r
y
a
a
a
a
a
W
F
a
a
a
a
a
a
"}
(42,1,1) = {"
a
a
a
a
a
a
F
a
a
a
a
a
a
a
a
a
a
a
a
a
a
a
a
a
a
r
a
a
a
a
a
a
r
a
a
r
a
a
a
a
a
m
h
F
a
a
a
a
a
a
"}
(43,1,1) = {"
a
a
a
a
a
a
F
a
a
a
a
a
a
a
a
a
a
a
a
a
a
a
a
a
a
r
Q
a
Z
Z
a
Q
r
a
a
r
t
t
t
t
t
t
t
F
a
a
a
a
a
a
"}
(44,1,1) = {"
a
a
a
a
a
a
F
F
F
F
F
F
F
F
F
F
F
F
F
F
F
F
F
F
F
F
F
F
F
F
F
F
F
F
F
F
F
F
F
F
F
F
F
F
a
a
a
a
a
a
"}
(45,1,1) = {"
a
a
a
a
a
a
a
a
a
a
a
a
a
a
a
a
a
a
a
a
a
a
a
a
a
a
a
a
a
a
a
a
a
a
a
a
a
a
a
a
a
a
a
a
a
a
a
a
a
a
"}
(46,1,1) = {"
a
a
a
a
a
a
a
a
a
a
a
a
a
a
a
a
a
a
a
a
a
a
a
a
a
a
a
a
a
a
a
a
a
a
a
a
a
a
a
a
a
a
a
a
a
a
a
a
a
a
"}
(47,1,1) = {"
a
a
a
a
a
a
a
a
a
a
a
a
a
a
a
a
a
a
a
a
a
a
a
a
a
a
a
a
a
a
a
a
a
a
a
a
a
a
a
a
a
a
a
a
a
a
a
a
a
a
"}
(48,1,1) = {"
a
a
a
a
a
a
a
a
a
a
a
a
a
a
a
a
a
a
a
a
a
a
a
a
a
a
a
a
a
a
a
a
a
a
a
a
a
a
a
a
a
a
a
a
a
a
a
a
a
a
"}
(49,1,1) = {"
a
a
a
a
a
a
a
a
a
a
a
a
a
a
a
a
a
a
a
a
a
a
a
a
a
a
a
a
a
a
a
a
a
a
a
a
a
a
a
a
a
a
a
a
a
a
a
a
a
a
"}
(50,1,1) = {"
a
a
a
a
a
a
a
a
a
a
a
a
a
a
a
a
a
a
a
a
a
a
a
a
a
a
a
a
a
a
a
a
a
a
a
a
a
a
a
a
a
a
a
a
a
a
a
a
a
a
"}
